1 2 5 0 0
2 0 3 1 0
3 0 2 0 4
4 0 3 5 0
5 4 0 0 1
